**********
*P...*..o*
***.*..E.*
*...*....*
*.E**.****
*..o..o..*
*E.*.*E*N*
**********
