***************
*P...*..o*...o*
***.*..E.*...E*
*...*....*E.***
*.E**.****...**
*..o..o..*...**
*E.*.*E*...E.N*
***************
