**************
*P     o    N*
*   ****     E *
*   o      E  *
**************
