**********
*P...*...*
***.*.*E.*
*...*.*..*
*.***.****
*..o..o..*
*E.*.***N*
**********
