***N***
**E..E*
**...o*
*o.o*.*
**E..E*
*.....*
**o**P*